أب: singular genitive nominative indefinite construct masculine imperative second adjective noun verb inflection=2b9d
أبا: singular accusative indefinite construct masculine noun inflection=2b9d
أرسل: singular imperfective perfective masculine imperative first second third past present verb inflection=d18
أسند: singular imperfective perfective masculine imperative first second third past present verb inflection=15f2
أي: particle
بيت: singular genitive nominative indefinite construct masculine noun inflection=3134
تذكير: singular genitive nominative indefinite construct masculine infinitive noun verb inflection=4c
تذكيرا: singular dual accusative nominative indefinite construct masculine noun inflection=4c
تذكيرات: plural nominative indefinite construct masculine noun inflection=4c
تذكيران: dual nominative indefinite masculine noun inflection=4c
تذكيري: dual accusative construct masculine noun inflection=4c
تذكيرين: dual accusative indefinite masculine noun inflection=4c
تلك: singular feminine determiner particle inflection=7ad
جميل: singular nominative indefinite construct masculine adjective noun proper-noun inflection=3 inflection=34a
ذلك: singular masculine determiner particle inflection=7ad
رسالة: singular nominative indefinite construct masculine feminine infinitive noun verb inflection=841
رسالتا: dual nominative construct feminine noun inflection=841
رسالتان: dual nominative indefinite feminine noun inflection=841
رسالتي: dual accusative construct feminine noun inflection=841
رسالتين: dual accusative indefinite feminine noun inflection=841
شربات: plural inanimate nominative indefinite construct feminine noun inflection=3f
شربة: singular inanimate nominative indefinite construct feminine noun inflection=3f
شربتا: dual inanimate perfective nominative construct feminine third past noun verb inflection=3f
شربتان: dual inanimate nominative indefinite feminine noun inflection=3f
طاولتي: dual accusative construct feminine noun inflection=2
طاولتين: dual accusative indefinite feminine noun inflection=2
عالق: singular nominative indefinite construct masculine adjective noun inflection=d
عالقا: dual nominative construct masculine adjective noun inflection=d
عالقات: plural nominative indefinite construct feminine adjective inflection=d
عالقان: dual nominative indefinite masculine adjective noun inflection=d
عالقة: singular nominative indefinite construct masculine feminine adjective noun inflection=d
عالقتا: dual nominative construct feminine adjective inflection=d
عالقتان: dual nominative indefinite feminine adjective inflection=d
عالقتي: dual accusative construct feminine adjective inflection=d
عالقتين: dual accusative indefinite feminine adjective inflection=d
عالقو: plural animate nominative construct masculine adjective inflection=d
عالقون: plural animate nominative indefinite construct masculine adjective noun inflection=d
عالقي: plural dual animate accusative construct masculine adjective noun inflection=d
عالقين: plural dual animate accusative indefinite masculine adjective noun inflection=d
كيلومتر: singular genitive nominative indefinite construct masculine noun inflection=4c
كيلومترا: singular dual accusative nominative indefinite construct masculine noun inflection=4c
كيلومترات: plural nominative indefinite construct masculine noun inflection=4c
كيلومتران: dual nominative indefinite masculine noun inflection=4c
كيلومتري: dual accusative construct masculine noun inflection=4c
كيلومترين: dual accusative indefinite masculine noun inflection=4c
مصر: singular perfective genitive nominative indefinite construct masculine imperative second third past present passive adjective noun proper-noun verb
مطاعم: plural nominative indefinite construct masculine participle active passive noun verb inflection=1894
مطعم: singular genitive nominative indefinite construct masculine participle active passive adjective noun verb inflection=7 inflection=18ff
مطعما: singular dual accusative nominative indefinite construct masculine adjective noun inflection=1894
مطعمان: dual nominative indefinite masculine adjective noun inflection=1894
مطعمي: plural dual accusative construct masculine adjective noun inflection=1894
مطعمين: plural dual accusative indefinite masculine adjective noun inflection=1894
معطل: singular nominative indefinite construct masculine participle passive adjective noun verb inflection=d
مغلق: singular inanimate nominative indefinite construct masculine participle active passive adjective noun verb inflection=7
مفتوح: singular nominative indefinite construct masculine participle passive adjective noun verb inflection=1
مقفل: singular nominative indefinite construct masculine participle active passive adjective noun verb inflection=1
هذا: singular masculine determiner inflection=1d33
هذه: singular feminine determiner inflection=1d33
ياردات: plural nominative indefinite construct masculine noun inflection=2d
ياردة: singular nominative indefinite construct masculine noun inflection=2d
ياردتا: dual nominative construct masculine noun inflection=2d
ياردتان: dual nominative indefinite masculine noun inflection=2d
ياردتي: dual accusative construct masculine noun inflection=2d
ياردتين: dual accusative indefinite masculine noun inflection=2d
يرسل: singular imperfective masculine third present verb inflection=d18
يعجب: singular imperfective masculine third present verb inflection=1f31
==============================================
Manually curated for tests to pass
Copyright 2024-2024 Apple Inc. All rights reserved.
