Ås: noun proper-noun inflection=6
absurd: singular indefinite adjective
administrasjon: singular indefinite masculine noun inflection=2
administrasjonen: singular definite masculine noun inflection=2
administrasjonene: plural definite masculine noun inflection=2
administrasjoner: plural indefinite masculine noun inflection=2
ås: singular genitive indefinite masculine feminine noun inflection=314
avtale: singular indefinite masculine noun verb inflection=7
belta: plural definite neuter noun inflection=16
beltas: plural genitive definite neuter noun inflection=16
belte: singular indefinite neuter noun inflection=16
belter: plural indefinite neuter noun inflection=1 inflection=16
belters: plural genitive indefinite neuter noun inflection=16
beltes: singular genitive indefinite neuter noun inflection=16
beltet: singular definite neuter noun inflection=1 inflection=16
beltets: singular genitive definite neuter noun inflection=16
bokmerke: singular indefinite neuter noun inflection=f
fast: singular indefinite adjective verb
gammel: singular indefinite adjective
høyest: singular plural indefinite adjective
høyeste: singular plural definite adjective
jazz: singular indefinite masculine noun verb inflection=12
lampa: singular definite feminine noun inflection=78
lampe: singular indefinite masculine feminine noun inflection=78
lunken: singular indefinite masculine adjective noun inflection=1
møte: singular indefinite neuter noun verb inflection=16
møter: plural indefinite neuter noun verb inflection=16
øvinga: singular definite feminine noun inflection=3
vogntoga: plural definite neuter noun inflection=4
budskap: singular plural indefinite neuter noun inflection=9
budskapa: plural definite neuter noun inflection=9
budskapas: plural genitive definite neuter noun inflection=9
budskapene: plural definite neuter noun inflection=9
budskapenes: plural genitive definite neuter noun inflection=9
budskaper: plural indefinite neuter noun inflection=9
budskapers: plural genitive indefinite neuter noun inflection=9
budskapet: singular definite neuter noun inflection=9
budskapets: singular genitive definite neuter noun inflection=9
budskaps: singular plural genitive indefinite neuter noun inflection=9
mann: singular indefinite masculine noun verb inflection=87
menn: plural indefinite masculine noun inflection=87
bildør: singular indefinite masculine feminine noun inflection=d2
bildøra: singular definite feminine noun inflection=d2
bildøras: singular genitive definite feminine noun inflection=d2
bildøren: singular definite masculine noun inflection=d2
bildørene: plural definite masculine feminine noun inflection=d2
bildørenes: plural genitive definite masculine feminine noun inflection=d2
bildørens: singular genitive definite masculine noun inflection=d2
bildører: plural indefinite masculine feminine noun inflection=d2
bildørers: plural genitive indefinite masculine feminine noun inflection=d2
bildørs: singular genitive indefinite masculine feminine noun inflection=d2
makaber: singular indefinite adjective
mor: singular indefinite masculine feminine noun verb inflection=30 inflection=3b
moren: singular definite masculine noun inflection=30
tykk: singular indefinite adjective
vennlig: singular indefinite adjective
praktisk: singular indefinite adjective
norsk: singular indefinite masculine adjective noun verb
god: singular indefinite adjective
skjørtet: noun inflection=1
==============================================
Manually curated for tests to pass
Copyright 2024-2024 Apple Inc. All rights reserved.
