a: adposition
abilitane: neuter imperative vowel-start verb inflection=69
allenato: singular masculine vowel-start past participle adjective verb inflection=1 inflection=8a
aperto: singular masculine vowel-start past participle adjective noun verb inflection=1 inflection=2 inflection=3e2
Apple: singular noun proper-noun inflection=3e
armadio: singular masculine vowel-start noun inflection=b
assideramento: singular masculine noun inflection=2
attore: singular masculine vowel-start noun inflection=10
automobile: singular masculine feminine vowel-start adjective noun inflection=5 inflection=6
automobili: plural masculine feminine vowel-start adjective noun inflection=5 inflection=6
banca: singular feminine noun inflection=1b
Barcellona: singular feminine noun proper-noun inflection=18
benvenuta: singular feminine adjective noun inflection=1 inflection=c
benvenuto: singular masculine adjective noun inflection=1 inflection=c
caffè: singular plural masculine noun inflection=7
capi: singular plural masculine indicative imperative subjunctive first second third present noun verb inflection=2 inflection=4
capo: singular masculine indicative first present noun verb inflection=2 inflection=4
casa: singular feminine noun inflection=3
case: plural feminine noun inflection=3
cassiere: singular plural masculine feminine noun inflection=3a
cinema: singular plural masculine noun inflection=7
cinematografico: singular masculine adjective inflection=a
connesso: singular masculine past participle adjective verb inflection=1 inflection=1d2
copyright: singular plural masculine noun inflection=7
cui: pronoun
delegato: singular masculine past participle adjective noun verb inflection=1 inflection=c inflection=11
di: singular plural masculine feminine indicative imperative subjunctive first second third present noun adposition verb inflection=e inflection=2a
donna: singular feminine noun inflection=3
dottore: singular masculine noun inflection=1fe
è: singular indicative third present verb inflection=210 inflection=211
Edoardo: singular masculine noun proper-noun inflection=2f
essere: singular masculine vowel-start infinitive noun verb inflection=8 inflection=210
gatta: singular feminine noun inflection=3 inflection=c
gatte: plural feminine noun inflection=3 inflection=c
Gatti: singular plural noun proper-noun inflection=1f
gatti: plural masculine noun inflection=c
gatto: singular plural masculine feminine adjective noun inflection=c inflection=1c
gnocchi: plural masculine noun inflection=1a
gnomo: singular masculine noun inflection=2
hotel: singular plural masculine vowel-start noun inflection=7
I: number
i: singular plural definite masculine feminine determiner noun inflection=9 inflection=239
il: singular definite masculine determiner inflection=239
in: adposition
Internet: singular plural masculine noun inflection=7
internet: singular plural masculine noun inflection=7
invitato: singular masculine vowel-start past participle adjective noun verb inflection=1 inflection=c inflection=69
iscritta: singular feminine vowel-start adjective noun inflection=1 inflection=c
iscritto: singular masculine vowel-start past participle adjective noun verb inflection=1 inflection=c inflection=6f
italiana: singular feminine indicative imperative second third vowel-start present adjective noun verb inflection=1 inflection=3 inflection=c inflection=20
italiane: plural feminine vowel-start adjective noun inflection=1 inflection=3 inflection=c
italiani: singular plural masculine indicative imperative subjunctive first second third vowel-start present adjective noun verb inflection=1 inflection=c inflection=20
italiano: singular masculine indicative first vowel-start present adjective noun verb inflection=1 inflection=c inflection=20
lavora: singular indicative imperative second third present verb inflection=4
letto: singular masculine past participle adjective noun verb inflection=1 inflection=2 inflection=5c
lunedì: singular plural masculine noun inflection=7
manager: singular plural masculine feminine noun inflection=2a
metro: singular masculine noun inflection=2
note: plural feminine adjective noun inflection=1 inflection=3
ombrellone: singular masculine vowel-start noun inflection=8
ora: singular feminine indicative imperative second third vowel-start present noun verb inflection=3 inflection=4
pastello: singular masculine adjective noun inflection=2 inflection=40
prima: singular feminine adjective noun number inflection=1 inflection=c
produttore: singular masculine adjective noun inflection=10 inflection=15
redattore: singular masculine noun inflection=10
regista: singular masculine feminine noun inflection=1e
salotti: plural masculine noun inflection=2
salotto: singular masculine noun inflection=2
sei: singular plural masculine feminine indicative second present noun verb inflection=2a inflection=210 inflection=211
settimana: singular feminine noun inflection=3
stanza: singular feminine noun inflection=3
Stato: singular masculine noun inflection=2
stato: singular masculine past participle adjective noun verb inflection=1 inflection=2 inflection=210 inflection=366
teatrale: singular masculine feminine adjective inflection=5
televisivo: singular masculine adjective inflection=1
un: singular indefinite masculine determiner inflection=3a2
una: singular indefinite feminine imperative second vowel-start adjective determiner number pronoun verb inflection=29 inflection=3a1 inflection=3a2
uno: singular indefinite masculine vowel-start adjective determiner number pronoun inflection=3a1 inflection=3a2
zio: singular masculine noun inflection=2
==============================================
Manually curated for tests to pass
Copyright 2024-2024 Apple Inc. All rights reserved.
