Александрыч: singular animate nominative patronymic masculine informal noun proper-noun inflection=4b
Александрыча: singular animate accusative genitive patronymic masculine informal noun proper-noun inflection=4b
Александрычам: plural animate dative patronymic masculine informal noun proper-noun inflection=4b
Александрычами: plural animate instrumental patronymic masculine informal noun proper-noun inflection=4b
Александрычах: plural animate prepositional patronymic masculine informal noun proper-noun inflection=4b
Александрыче: singular animate prepositional patronymic masculine informal noun proper-noun inflection=4b
Александрычей: plural animate accusative genitive patronymic masculine informal noun proper-noun inflection=4b
Александрычем: singular animate instrumental patronymic masculine informal noun proper-noun inflection=4b
Александрычен: plural animate accusative genitive patronymic feminine informal noun proper-noun inflection=4b
Александрычи: plural animate nominative patronymic masculine informal noun proper-noun inflection=4b
Александрычна: singular animate nominative patronymic feminine informal noun proper-noun inflection=4b
Александрычнам: plural animate dative patronymic feminine informal noun proper-noun inflection=4b
Александрычнами: plural animate instrumental patronymic feminine informal noun proper-noun inflection=4b
Александрычнах: plural animate prepositional patronymic feminine informal noun proper-noun inflection=4b
Александрычне: singular animate dative prepositional patronymic feminine informal noun proper-noun inflection=4b
Александрычной: singular animate instrumental patronymic feminine informal noun proper-noun inflection=4b
Александрычну: singular animate accusative patronymic feminine informal noun proper-noun inflection=4b
Александрычны: singular plural animate genitive nominative patronymic feminine informal noun proper-noun inflection=4b
Александрычу: singular animate dative patronymic masculine informal noun proper-noun inflection=4b
Алексиевич: singular plural animate accusative dative genitive instrumental nominative prepositional masculine feminine familyname noun proper-noun inflection=3f
Алексиевича: singular animate accusative genitive masculine familyname noun proper-noun inflection=3f
Алексиевичам: plural animate dative masculine familyname noun proper-noun inflection=3f
Алексиевичами: plural animate instrumental masculine familyname noun proper-noun inflection=3f
Алексиевичах: plural animate prepositional masculine familyname noun proper-noun inflection=3f
Алексиевиче: singular animate prepositional masculine familyname noun proper-noun inflection=3f
Алексиевичей: plural animate accusative genitive masculine familyname noun proper-noun inflection=3f
Алексиевичем: singular animate instrumental masculine familyname noun proper-noun inflection=3f
Алексиевичи: plural animate nominative masculine familyname noun proper-noun inflection=3f
Алексиевичу: singular animate dative masculine familyname noun proper-noun inflection=3f
Анатолие: singular animate prepositional masculine noun proper-noun inflection=169
Анатолиев: plural animate accusative genitive masculine noun proper-noun inflection=169
Анатолием: singular animate instrumental masculine noun proper-noun inflection=169
Анатолии: singular plural animate dative genitive nominative prepositional masculine feminine noun proper-noun inflection=169
Анатолий: singular plural animate accusative genitive nominative masculine feminine noun proper-noun inflection=169
Анатолич: singular animate nominative patronymic masculine informal noun proper-noun inflection=169
Анатолича: singular animate accusative genitive patronymic masculine informal noun proper-noun inflection=169
Анатоличам: plural animate dative patronymic masculine informal noun proper-noun inflection=169
Анатоличами: plural animate instrumental patronymic masculine informal noun proper-noun inflection=169
Анатоличах: plural animate prepositional patronymic masculine informal noun proper-noun inflection=169
Анатоличе: singular animate prepositional patronymic masculine informal noun proper-noun inflection=169
Анатоличей: plural animate accusative genitive patronymic masculine informal noun proper-noun inflection=169
Анатоличем: singular animate instrumental patronymic masculine informal noun proper-noun inflection=169
Анатоличен: plural animate accusative genitive patronymic feminine informal noun proper-noun inflection=169
Анатоличи: plural animate nominative patronymic masculine informal noun proper-noun inflection=169
Анатолична: singular animate nominative patronymic feminine informal noun proper-noun inflection=169
Анатоличнам: plural animate dative patronymic feminine informal noun proper-noun inflection=169
Анатоличнами: plural animate instrumental patronymic feminine informal noun proper-noun inflection=169
Анатоличнах: plural animate prepositional patronymic feminine informal noun proper-noun inflection=169
Анатоличне: singular animate dative prepositional patronymic feminine informal noun proper-noun inflection=169
Анатоличной: singular animate instrumental patronymic feminine informal noun proper-noun inflection=169
Анатоличну: singular animate accusative patronymic feminine informal noun proper-noun inflection=169
Анатоличны: singular plural animate genitive nominative patronymic feminine informal noun proper-noun inflection=169
Анатоличу: singular animate dative patronymic masculine informal noun proper-noun inflection=169
Анатолию: singular animate accusative dative masculine feminine noun proper-noun inflection=169
Анатолия: singular animate accusative genitive nominative masculine feminine noun proper-noun inflection=169
Анатолиям: plural animate dative masculine feminine noun proper-noun inflection=169
Анатолиями: plural animate instrumental masculine feminine noun proper-noun inflection=169
Анатолиях: plural animate prepositional masculine feminine noun proper-noun inflection=169
Анатольевен: plural animate accusative genitive patronymic feminine noun proper-noun inflection=169
Анатольевич: singular animate nominative patronymic masculine familyname noun proper-noun inflection=169
Анатольевича: singular animate accusative genitive patronymic masculine familyname noun proper-noun inflection=169
Анатольевичам: plural animate dative patronymic masculine familyname noun proper-noun inflection=169
Анатольевичами: plural animate instrumental patronymic masculine familyname noun proper-noun inflection=169
Анатольевичах: plural animate prepositional patronymic masculine familyname noun proper-noun inflection=169
Анатольевиче: singular animate prepositional patronymic masculine familyname noun proper-noun inflection=169
Анатольевичей: plural animate accusative genitive patronymic masculine familyname noun proper-noun inflection=169
Анатольевичем: singular animate instrumental patronymic masculine familyname noun proper-noun inflection=169
Анатольевичи: plural animate nominative patronymic masculine familyname noun proper-noun inflection=169
Анатольевичу: singular animate dative patronymic masculine familyname noun proper-noun inflection=169
Анатольевна: singular animate nominative patronymic feminine noun proper-noun inflection=169
Анатольевнам: plural animate dative patronymic feminine noun proper-noun inflection=169
Анатольевнами: plural animate instrumental patronymic feminine noun proper-noun inflection=169
Анатольевнах: plural animate prepositional patronymic feminine noun proper-noun inflection=169
Иванов: singular plural animate accusative genitive nominative masculine familyname noun proper-noun
Ивановен: plural animate accusative genitive patronymic feminine noun proper-noun inflection=4b
Иванович: singular animate nominative patronymic masculine noun proper-noun inflection=4b
Ивановича: singular animate accusative genitive patronymic masculine noun proper-noun inflection=4b
Ивановичам: plural animate dative patronymic masculine noun proper-noun inflection=4b
Ивановичами: plural animate instrumental patronymic masculine noun proper-noun inflection=4b
Ивановичах: plural animate prepositional patronymic masculine noun proper-noun inflection=4b
Ивановиче: singular animate prepositional patronymic masculine noun proper-noun inflection=4b
Ивановичей: plural animate accusative genitive patronymic masculine noun proper-noun inflection=4b
Ивановичем: singular animate instrumental patronymic masculine noun proper-noun inflection=4b
Ивановичи: plural animate nominative patronymic masculine noun proper-noun inflection=4b
Ивановичу: singular animate dative patronymic masculine noun proper-noun inflection=4b
Ивановна: singular animate nominative patronymic feminine noun proper-noun
Иваны: plural animate nominative masculine noun proper-noun inflection=4b
Иваныч: singular animate nominative patronymic masculine informal noun proper-noun inflection=4b
Иваныча: singular animate accusative genitive patronymic masculine informal noun proper-noun inflection=4b
Иванычам: plural animate dative patronymic masculine informal noun proper-noun inflection=4b
Иванычами: plural animate instrumental patronymic masculine informal noun proper-noun inflection=4b
Иванычах: plural animate prepositional patronymic masculine informal noun proper-noun inflection=4b
Иваныче: singular animate prepositional patronymic masculine informal noun proper-noun inflection=4b
Иванычей: plural animate accusative genitive patronymic masculine informal noun proper-noun inflection=4b
Иванычем: singular animate instrumental patronymic masculine informal noun proper-noun inflection=4b
Иванычен: plural animate accusative genitive patronymic feminine informal noun proper-noun inflection=4b
Иванычи: plural animate nominative patronymic masculine informal noun proper-noun inflection=4b
Иванычна: singular animate nominative patronymic feminine informal noun proper-noun inflection=4b
Иванычнам: plural animate dative patronymic feminine informal noun proper-noun inflection=4b
Иванычнами: plural animate instrumental patronymic feminine informal noun proper-noun inflection=4b
Иванычнах: plural animate prepositional patronymic feminine informal noun proper-noun inflection=4b
Иванычне: singular animate dative prepositional patronymic feminine informal noun proper-noun inflection=4b
Иванычной: singular animate instrumental patronymic feminine informal noun proper-noun inflection=4b
Иванычну: singular animate accusative patronymic feminine informal noun proper-noun inflection=4b
Иванычны: singular plural animate genitive nominative patronymic feminine informal noun proper-noun inflection=4b
Иванычу: singular animate dative patronymic masculine informal noun proper-noun inflection=4b
Майкл: singular animate nominative masculine noun proper-noun inflection=34
Майкла: singular animate accusative genitive masculine noun proper-noun inflection=34
Майклам: plural animate dative masculine noun proper-noun inflection=34
Майклами: plural animate instrumental masculine noun proper-noun inflection=34
Майклах: plural animate prepositional masculine noun proper-noun inflection=34
Майкле: singular animate prepositional masculine noun proper-noun inflection=34
аббатство: singular inanimate accusative nominative neuter noun
автобус: singular inanimate accusative nominative masculine noun inflection=1
автобуса: singular inanimate genitive masculine noun inflection=1
автобусам: plural inanimate dative masculine noun inflection=1
автобусами: plural inanimate instrumental masculine noun inflection=1
автобусах: plural inanimate prepositional masculine noun inflection=1
автобусе: singular inanimate prepositional masculine noun inflection=1
автобусов: plural inanimate genitive masculine noun inflection=1
автобусом: singular inanimate instrumental masculine noun inflection=1
автобусу: singular inanimate dative masculine noun inflection=1
автобусы: plural inanimate accusative nominative masculine noun inflection=1
бело: singular short-form neuter adjective inflection=10
большая: singular nominative feminine adjective inflection=1f3d
больше: comparative adjective adverb inflection=1f3d
большие: plural inanimate accusative nominative masculine feminine neuter adjective inflection=1f3d
большим: singular plural dative instrumental masculine feminine neuter adjective inflection=1f3d
большими: plural instrumental masculine feminine neuter adjective inflection=1f3d
больших: plural animate accusative genitive prepositional masculine feminine neuter adjective inflection=1f3d
большого: singular animate accusative genitive masculine neuter adjective inflection=1f3d
большое: singular animate inanimate accusative nominative neuter adjective inflection=1f3d
большой: singular inanimate accusative dative genitive instrumental nominative prepositional masculine feminine adjective inflection=1f3d
большом: singular prepositional masculine neuter adjective inflection=1f3d
большому: singular dative masculine neuter adjective inflection=1f3d
большую: singular animate inanimate accusative feminine adjective inflection=1f3d
быстр: singular short-form masculine adjective inflection=1fb1
быстра: singular short-form feminine adjective inflection=1fb1
быстрая: singular nominative feminine adjective inflection=1fb1
быстрее: comparative adjective adverb inflection=1fb1
быстрей: comparative conversational adjective adverb inflection=1fb1
быстрейшая: singular nominative superlative feminine adjective inflection=1fb1
быстрейшего: singular animate accusative genitive superlative masculine neuter adjective inflection=1fb1
быстрейшее: singular animate inanimate accusative nominative superlative neuter adjective inflection=1fb1
быстрейшей: singular dative genitive instrumental prepositional superlative feminine adjective inflection=1fb1
быстрейшем: singular prepositional superlative masculine neuter adjective inflection=1fb1
быстрейшему: singular dative superlative masculine neuter adjective inflection=1fb1
быстрейшие: plural inanimate accusative nominative superlative masculine feminine neuter adjective inflection=1fb1
быстрейший: singular inanimate accusative nominative superlative masculine adjective inflection=1fb1
быстрейшим: singular plural dative instrumental superlative masculine feminine neuter adjective inflection=1fb1
быстрейшими: plural instrumental superlative masculine feminine neuter adjective inflection=1fb1
быстрейших: plural animate accusative genitive prepositional superlative masculine feminine neuter adjective inflection=1fb1
быстрейшую: singular animate inanimate accusative superlative feminine adjective inflection=1fb1
быстро: singular short-form neuter adjective adverb inflection=1fb1
быстрого: singular animate accusative genitive masculine neuter adjective inflection=1fb1
быстрое: singular animate inanimate accusative nominative neuter adjective inflection=1fb1
быстрой: singular dative genitive instrumental prepositional feminine adjective inflection=1fb1
быстром: singular prepositional masculine neuter adjective inflection=1fb1
быстрому: singular dative masculine neuter adjective inflection=1fb1
быструю: singular animate inanimate accusative feminine adjective inflection=1fb1
быстры: plural short-form masculine feminine neuter adjective inflection=1fb1
быстрые: plural inanimate accusative nominative masculine feminine neuter adjective inflection=1fb1
быстрый: singular inanimate accusative nominative masculine adjective inflection=1fb1
быстрым: singular plural dative instrumental masculine feminine neuter adjective inflection=1fb1
быстрыми: plural instrumental masculine feminine neuter adjective inflection=1fb1
быстрых: plural animate accusative genitive prepositional masculine feminine neuter adjective inflection=1fb1
вечер: singular inanimate accusative nominative masculine noun inflection=10b
вечера: singular plural inanimate accusative genitive nominative masculine noun inflection=10b
вечерам: plural inanimate dative masculine noun inflection=10b
вечерами: plural inanimate instrumental masculine noun inflection=10b
вечерах: plural inanimate prepositional masculine noun inflection=10b
вечере: singular inanimate dative prepositional masculine feminine noun inflection=10b
вечеров: plural inanimate genitive masculine noun inflection=10b
вечером: singular inanimate instrumental masculine noun inflection=10b
вечеру: singular inanimate dative masculine noun inflection=10b
второго: singular animate inanimate accusative genitive masculine neuter noun number inflection=b6
второе: singular animate inanimate accusative nominative neuter noun number inflection=b6
день: singular inanimate accusative nominative masculine imperative noun verb inflection=601
дерева: singular inanimate genitive neuter noun inflection=304
дереве: singular inanimate prepositional neuter noun inflection=304
дерево: singular inanimate accusative nominative neuter noun inflection=304
деревом: singular inanimate instrumental neuter noun inflection=304
дереву: singular inanimate dative neuter noun inflection=304
деревьев: plural inanimate genitive neuter noun inflection=304
деревья: plural inanimate accusative nominative neuter noun inflection=304
деревьям: plural inanimate dative neuter noun inflection=304
деревьями: plural inanimate instrumental neuter noun inflection=304
деревьях: plural inanimate prepositional neuter noun inflection=304
дня: singular inanimate genitive masculine noun inflection=601
женщина: singular animate nominative feminine noun inflection=72
женщинам: plural animate dative feminine noun inflection=72
женщинами: plural animate instrumental feminine noun inflection=72
женщинах: plural animate prepositional feminine noun inflection=72
женщине: singular animate dative prepositional feminine noun inflection=72
женщиной: singular animate instrumental feminine noun inflection=72
женщиною: singular animate instrumental feminine noun inflection=72
женщину: singular animate accusative feminine noun inflection=72
женщины: singular plural animate genitive nominative feminine noun inflection=72
завтрашнего: singular animate accusative genitive masculine neuter adjective inflection=73
завтрашнее: singular animate inanimate accusative nominative neuter adjective inflection=73
завтрашней: singular dative genitive instrumental prepositional feminine adjective inflection=73
завтрашнем: singular prepositional masculine neuter adjective inflection=73
завтрашнему: singular dative masculine neuter adjective inflection=73
завтрашние: plural inanimate accusative nominative masculine feminine neuter adjective inflection=73
завтрашний: singular inanimate accusative nominative masculine adjective inflection=73
завтрашним: singular plural dative instrumental masculine feminine neuter adjective inflection=73
завтрашними: plural instrumental masculine feminine neuter adjective inflection=73
завтрашних: plural animate accusative genitive prepositional masculine feminine neuter adjective inflection=73
завтрашнюю: singular animate inanimate accusative feminine adjective inflection=73
завтрашняя: singular nominative feminine adjective inflection=73
карандаш: singular inanimate accusative nominative masculine noun inflection=55
карандаша: singular inanimate genitive masculine noun inflection=55
карандашам: plural inanimate dative masculine noun inflection=55
карандашами: plural inanimate instrumental masculine noun inflection=55
карандашах: plural inanimate prepositional masculine noun inflection=55
карандаше: singular inanimate prepositional masculine noun inflection=55
карандашей: plural inanimate genitive masculine noun inflection=55
карандаши: plural inanimate accusative nominative masculine noun inflection=55
километр: singular inanimate accusative nominative masculine noun inflection=1
километра: singular inanimate genitive masculine noun inflection=1
километрам: plural inanimate dative masculine noun inflection=1
километрами: plural inanimate instrumental masculine noun inflection=1
километрах: plural inanimate prepositional masculine noun inflection=1
километре: singular inanimate prepositional masculine noun inflection=1
километров: plural inanimate genitive masculine noun inflection=1
километром: singular inanimate instrumental masculine noun inflection=1
километру: singular inanimate dative masculine noun inflection=1
километры: plural inanimate accusative nominative masculine noun inflection=1
корзин: plural inanimate genitive feminine noun inflection=b
корзина: singular inanimate nominative feminine noun inflection=b
корзинам: plural inanimate dative feminine noun inflection=b
корзинами: plural inanimate instrumental feminine noun inflection=b
корзинах: plural inanimate prepositional feminine noun inflection=b
корзине: singular inanimate dative prepositional feminine noun inflection=b
корзиной: singular inanimate instrumental feminine noun inflection=b
корзиною: singular inanimate instrumental feminine noun inflection=b
корзину: singular inanimate accusative feminine noun inflection=b
корзины: singular plural inanimate accusative genitive nominative feminine noun inflection=b
кошка: singular animate nominative feminine noun inflection=5e
кошкам: plural animate dative feminine noun inflection=5e
кошками: plural animate instrumental feminine noun inflection=5e
кошках: plural animate prepositional feminine noun inflection=5e
кошке: singular animate dative prepositional feminine noun inflection=5e
кошки: singular plural animate genitive nominative feminine noun inflection=5e
красив: singular short-form masculine adjective inflection=b9f
красива: singular short-form feminine adjective inflection=b9f
красивая: singular nominative feminine adjective inflection=b9f
красивее: comparative adjective adverb inflection=b9f
красивей: comparative conversational adjective adverb inflection=b9f
красиво: singular short-form neuter adjective adverb inflection=b9f
красивого: singular animate accusative genitive masculine neuter adjective inflection=b9f
красивое: singular animate inanimate accusative nominative neuter adjective inflection=b9f
красивой: singular dative genitive instrumental prepositional feminine adjective inflection=b9f
красивом: singular prepositional masculine neuter adjective inflection=b9f
красивому: singular dative masculine neuter adjective inflection=b9f
красивы: plural short-form masculine feminine neuter adjective inflection=b9f
красивые: plural inanimate accusative nominative masculine feminine neuter adjective inflection=b9f
красивый: singular inanimate accusative nominative masculine adjective inflection=b9f
красивым: singular plural dative instrumental masculine feminine neuter adjective inflection=b9f
красивыми: plural instrumental masculine feminine neuter adjective inflection=b9f
красивых: plural animate accusative genitive prepositional masculine feminine neuter adjective inflection=b9f
лена: singular animate accusative genitive nominative masculine feminine familyname noun proper-noun inflection=7
лимонадная: singular nominative feminine adjective inflection=2
лимонадного: singular animate accusative genitive masculine neuter adjective inflection=2
лимонадное: singular animate inanimate accusative nominative neuter adjective inflection=2
лимонадной: singular dative genitive instrumental prepositional feminine adjective inflection=2
лимонадном: singular prepositional masculine neuter adjective inflection=2
лимонадному: singular dative masculine neuter adjective inflection=2
лимонадную: singular animate inanimate accusative feminine adjective inflection=2
лимонадные: plural inanimate accusative nominative masculine feminine neuter adjective inflection=2
лимонадный: singular inanimate accusative nominative masculine adjective inflection=2
лимонадным: singular plural dative instrumental masculine feminine neuter adjective inflection=2
лимонадными: plural instrumental masculine feminine neuter adjective inflection=2
лимонадных: plural animate accusative genitive prepositional masculine feminine neuter adjective inflection=2
людей: plural animate accusative genitive masculine noun inflection=1833
люди: plural animate nominative masculine noun inflection=1833
людям: plural animate dative masculine noun inflection=1833
людями: plural animate instrumental masculine noun inflection=1833
людях: plural animate prepositional masculine noun inflection=1833
мам: plural animate accusative genitive feminine interjection noun inflection=c71
мама: singular animate nominative feminine noun inflection=c71
мамам: plural animate dative feminine noun inflection=c71
мамами: plural animate instrumental feminine noun inflection=c71
муж: singular animate accusative nominative masculine noun inflection=cf7
мужа: singular animate genitive masculine noun inflection=cf7
мужам: plural animate dative masculine noun inflection=cf7
мужами: plural animate instrumental masculine noun inflection=cf7
мужах: plural animate prepositional masculine noun inflection=cf7
муже: singular animate prepositional masculine noun inflection=cf7
мужей: plural animate accusative genitive masculine noun inflection=cf7
наибольшая: singular nominative superlative feminine adjective inflection=1f3d
наибольшего: singular animate accusative genitive superlative masculine neuter adjective inflection=1f3d
наибольшее: singular animate inanimate accusative nominative superlative neuter adjective inflection=1f3d
наибольшей: singular dative genitive instrumental prepositional superlative feminine adjective inflection=1f3d
наибольшем: singular prepositional superlative masculine neuter adjective inflection=1f3d
наибольшему: singular dative superlative masculine neuter adjective inflection=1f3d
наибольшие: plural inanimate accusative nominative superlative masculine feminine neuter adjective inflection=1f3d
наибольший: singular inanimate accusative nominative superlative masculine adjective inflection=1f3d
наибольшим: singular plural dative instrumental superlative masculine feminine neuter adjective inflection=1f3d
наибольшими: plural instrumental superlative masculine feminine neuter adjective inflection=1f3d
наибольших: plural animate accusative genitive prepositional superlative masculine feminine neuter adjective inflection=1f3d
наибольшую: singular animate inanimate accusative superlative feminine adjective inflection=1f3d
наибыстрейшая: singular nominative superlative feminine adjective inflection=1fb1
наибыстрейшего: singular animate accusative genitive superlative masculine neuter adjective inflection=1fb1
наибыстрейшее: singular animate inanimate accusative nominative superlative neuter adjective inflection=1fb1
наибыстрейшей: singular dative genitive instrumental prepositional superlative feminine adjective inflection=1fb1
наибыстрейшем: singular prepositional superlative masculine neuter adjective inflection=1fb1
наибыстрейшему: singular dative superlative masculine neuter adjective inflection=1fb1
наибыстрейшие: plural inanimate accusative nominative superlative masculine feminine neuter adjective inflection=1fb1
наибыстрейший: singular inanimate accusative nominative superlative masculine adjective inflection=1fb1
наибыстрейшим: singular plural dative instrumental superlative masculine feminine neuter adjective inflection=1fb1
наибыстрейшими: plural instrumental superlative masculine feminine neuter adjective inflection=1fb1
наибыстрейших: plural animate accusative genitive prepositional superlative masculine feminine neuter adjective inflection=1fb1
наибыстрейшую: singular animate inanimate accusative superlative feminine adjective inflection=1fb1
не: adverb particle
ольг: plural animate accusative genitive feminine noun proper-noun inflection=e0
ольга: singular animate nominative feminine noun proper-noun inflection=e0
ольгам: plural animate dative feminine noun proper-noun inflection=e0
ольгами: plural animate instrumental feminine noun proper-noun inflection=e0
ольгах: plural animate prepositional feminine noun proper-noun inflection=e0
ольге: singular animate dative prepositional feminine noun proper-noun inflection=e0
ольги: singular plural animate genitive nominative feminine noun proper-noun inflection=e0
побольше: comparative adjective adverb inflection=1f3d
побыстрее: comparative adjective adverb inflection=1fb1
побыстрей: comparative conversational adjective adverb inflection=1fb1
пятого: singular animate accusative genitive masculine neuter number inflection=eb
пятое: singular animate inanimate accusative nominative neuter number inflection=eb
пятой: singular inanimate dative genitive instrumental prepositional feminine noun number inflection=eb
пятом: singular prepositional masculine neuter number inflection=eb
пятому: singular dative masculine neuter number inflection=eb
ремонт: singular inanimate accusative nominative masculine noun inflection=1
ремонта: singular inanimate genitive masculine noun inflection=1
ремонтам: plural inanimate dative masculine noun inflection=1
ремонтами: plural inanimate instrumental masculine noun inflection=1
ремонтах: plural inanimate prepositional masculine noun inflection=1
ремонте: singular inanimate prepositional masculine noun inflection=1
ресторан: singular inanimate accusative nominative masculine noun inflection=1
ресторана: singular inanimate genitive masculine noun inflection=1
ресторанам: plural inanimate dative masculine noun inflection=1
ресторанами: plural inanimate instrumental masculine noun inflection=1
ресторанах: plural inanimate prepositional masculine noun inflection=1
ресторане: singular inanimate prepositional masculine noun inflection=1
саду: singular inanimate dative masculine noun inflection=1
сады: plural inanimate accusative nominative masculine noun inflection=1
сантиметр: singular inanimate accusative nominative masculine noun inflection=1
сегодняшне: singular short-form neuter adjective inflection=2ce
сегодняшнего: singular animate accusative genitive masculine neuter adjective inflection=2ce
сегодняшнее: singular animate inanimate accusative nominative neuter adjective inflection=2ce
сегодняшней: singular dative genitive instrumental prepositional feminine adjective inflection=2ce
сегодняшнем: singular prepositional masculine neuter adjective inflection=2ce
сегодняшнему: singular dative masculine neuter adjective inflection=2ce
сегодняшни: plural short-form masculine feminine neuter adjective inflection=2ce
сегодняшние: plural inanimate accusative nominative masculine feminine neuter adjective inflection=2ce
сегодняшний: singular inanimate accusative nominative masculine adjective inflection=2ce
сегодняшним: singular plural dative instrumental masculine feminine neuter adjective inflection=2ce
сегодняшними: plural instrumental masculine feminine neuter adjective inflection=2ce
сегодняшних: plural animate accusative genitive prepositional masculine feminine neuter adjective inflection=2ce
сегодняшнюю: singular animate inanimate accusative feminine adjective inflection=2ce
сегодняшня: singular short-form feminine adjective inflection=2ce
сегодняшняя: singular nominative feminine adjective inflection=2ce
склероз: singular inanimate accusative nominative masculine noun inflection=1
склероза: singular inanimate genitive masculine noun inflection=1
склерозам: plural inanimate dative masculine noun inflection=1
склерозами: plural inanimate instrumental masculine noun inflection=1
склерозах: plural inanimate prepositional masculine noun inflection=1
склерозе: singular inanimate prepositional masculine noun inflection=1
склерозов: plural inanimate genitive masculine noun inflection=1
склерозом: singular inanimate instrumental masculine noun inflection=1
склерозу: singular inanimate dative masculine noun inflection=1
склерозы: plural inanimate accusative nominative masculine noun inflection=1
сообщение: singular inanimate accusative nominative neuter noun inflection=3
сообщением: singular inanimate instrumental neuter noun inflection=3
сообщении: singular inanimate prepositional neuter noun inflection=3
сообщений: plural inanimate genitive neuter noun inflection=3
сообщению: singular inanimate dative neuter noun inflection=3
сообщения: singular plural inanimate accusative genitive nominative neuter noun inflection=3
сообщениям: plural inanimate dative neuter noun inflection=3
сообщениями: plural inanimate instrumental neuter noun inflection=3
сообщениях: plural inanimate prepositional neuter noun inflection=3
сред: plural inanimate genitive feminine noun inflection=b
среда: singular inanimate nominative feminine noun inflection=b
средам: plural inanimate dative feminine noun inflection=b
средами: plural inanimate instrumental feminine noun inflection=b
средах: plural inanimate prepositional feminine noun inflection=b
среде: singular inanimate dative prepositional feminine noun inflection=b
стол: singular inanimate accusative nominative masculine noun inflection=1
стола: singular inanimate genitive masculine noun inflection=1
столам: plural inanimate dative masculine noun inflection=1
столами: plural inanimate instrumental masculine noun inflection=1
столе: singular inanimate prepositional masculine noun inflection=1
столов: plural inanimate genitive masculine noun inflection=1
столом: singular inanimate instrumental masculine noun inflection=1
столу: singular inanimate dative masculine noun inflection=1
струп: singular inanimate accusative nominative masculine noun inflection=30a
струпа: singular inanimate genitive masculine noun inflection=30a
струпе: singular inanimate prepositional masculine noun inflection=30a
струпом: singular inanimate instrumental masculine noun inflection=30a
струпу: singular inanimate dative masculine noun inflection=30a
струпьев: plural inanimate genitive masculine noun inflection=30a
струпья: plural inanimate accusative nominative masculine noun inflection=30a
струпьям: plural inanimate dative masculine noun inflection=30a
струпьями: plural inanimate instrumental masculine noun inflection=30a
струпьях: plural inanimate prepositional masculine noun inflection=30a
стул: singular inanimate accusative nominative masculine noun inflection=30a
стула: singular inanimate genitive masculine noun inflection=30a
стуле: singular inanimate prepositional masculine noun inflection=30a
стулом: singular inanimate instrumental masculine noun inflection=30a
стулу: singular inanimate dative masculine noun inflection=30a
стульев: plural inanimate genitive masculine noun inflection=30a
стулья: plural inanimate accusative nominative masculine noun inflection=30a
стульям: plural inanimate dative masculine noun inflection=30a
стульями: plural inanimate instrumental masculine noun inflection=30a
стульях: plural inanimate prepositional masculine noun inflection=30a
суббот: plural inanimate genitive feminine noun inflection=2e
суббота: singular inanimate nominative feminine noun inflection=2e
субботам: plural inanimate dative feminine noun inflection=2e
субботами: plural inanimate instrumental feminine noun inflection=2e
субботах: plural inanimate prepositional feminine noun inflection=2e
субботе: singular inanimate dative prepositional feminine noun inflection=2e
таджикистан: singular inanimate accusative nominative masculine noun proper-noun inflection=1ca3
таджикистана: singular inanimate genitive masculine noun proper-noun inflection=1ca3
таджикистанам: plural inanimate dative masculine noun proper-noun inflection=1ca3
таджикистанами: plural inanimate instrumental masculine noun proper-noun inflection=1ca3
таджикистанах: plural inanimate prepositional masculine noun proper-noun inflection=1ca3
таджикистане: singular inanimate prepositional masculine noun proper-noun inflection=1ca3
таджикистанов: plural inanimate genitive masculine noun proper-noun inflection=1ca3
таджикистаном: singular inanimate instrumental masculine noun proper-noun inflection=1ca3
таджикистану: singular inanimate dative masculine noun proper-noun inflection=1ca3
таджикистаны: plural inanimate accusative nominative masculine noun proper-noun inflection=1ca3
утро: singular inanimate accusative nominative neuter noun inflection=12
утром: singular inanimate instrumental neuter noun inflection=12
утру: singular inanimate dative neuter noun inflection=12
центр: singular inanimate accusative nominative masculine noun inflection=1
центра: singular inanimate genitive masculine noun inflection=1
централ: singular inanimate accusative nominative masculine noun inflection=1
централа: singular inanimate genitive masculine noun inflection=1
централам: plural inanimate dative masculine noun inflection=1
централами: plural inanimate instrumental masculine noun inflection=1
централах: plural inanimate prepositional masculine noun inflection=1
централе: singular inanimate prepositional masculine noun inflection=1
человек: singular animate nominative masculine noun inflection=1833
человека: singular animate accusative genitive masculine noun inflection=1833
человекам: plural animate dative masculine noun inflection=1833
человеками: plural animate instrumental masculine noun inflection=1833
человеках: plural animate prepositional masculine noun inflection=1833
человеке: singular animate prepositional masculine noun inflection=1833
человеки: plural animate nominative masculine noun inflection=1833
человеков: plural animate accusative genitive masculine noun inflection=1833
человеком: singular animate instrumental masculine noun inflection=1833
человеку: singular animate dative masculine noun inflection=1833
==============================================
Manually curated for tests to pass
Copyright 2024-2024 Apple Inc. All rights reserved.
